C 225,30,1
F 220,100,0

EA ./textures/dr.png
NO ./textures/ferb.png
SO ./textures/phineas.png
WE ./textures/perry.png



1111111111     1111111111111111111111111111111       11111111111111111111111111111           111111111111
1000000001    10000000000000000000000000000001       10000000000000000000000000001           100000000001
1000000001   100000000111000000000000000000001       10000000000000111000000000001           100000000001
1000000001  1000000001111000000000000000000001       100000000000001  100000000001           100000000001
1000000001 10000000011111000000001111111111111       100000000000001  100000000001           100000000001
1000000001100000000111111000000001                   100000000000001  100000000001           100000000001
1000000000000000001111111000000001                   100000000000001  100000000001           100000000001
100000000000000000111111100000000111111111111        100000000000001  100000000001           100000000001
10000000N000000000111111100000000000000000001        100000000000001  100000000001           100000000001
100000000000000000111111100000000000000000001        100000000000001  100000000001           100000000001
100000000000000000111111100000000111111111111        100000000000001  100000000001           100000000001
1000000001100000000111111000000001                   100000000000001  100000000001           100000000001
1000000001 10000000011111000000001                  1000000000000001  100000000001           100000000001
1000000001  1000000001111000000001                 10000000000000001  100000000001           100000000001
1000000001   1000000001110000000011111111111111   100000000000000001  10000000000111111111111100000000001
1000000001    10000000000000000000000000000000111100000000000000001   10000000000000000000000000000000001
1000000001     100000000000000000000000000000000000000000000000001    10000000000000000000000000000000001
1000000001      1000000000000000000000000000000000000000000011111      100000000000000000000000000000001
1111111111       1111111111111111111111111111111111111111111            1111111111111111111111111111111