NO ./path_to_the_north_texture
SO ./path_to_the_south_texture
C 225,30,1
EA ./path_to_the_east_texture
F 220,100,0
WE ./path_to_the_west_texture





1111111111     1111111111111111111111111111111
1000000001    10000000000000000000000000000001
1000000001   100000000111000000000000000000001
1000000001  1000000001  1000000000000000000001
1000000001 1000000001   1000000001111111111111
10000000011000000001    1000000001
1000000000000000001     1000000001
1000000000000000001     100000000111111111111
10000000N0000000001     100000000000000000001
1000000000000000001     100000000000000000001
1000000000000000001     100000000111111111111
10000000011000000001    1000000001
1000000001 1000000001   1000000001
1000000001  1000000001  1000000001
1000000001   1000000001110000000011111111111111
1000000001    100000000010000000000000000000001
1000000001     10000000010000000000000000000001
1000000001      1000000000000000000000000000001
1111111111       111111111111111111111111111111