EA ./textures/cutie1280.png
NO ./textures/dr1280.png
SO ./textures/ferb1280.png
WE ./textures/phineas1280.png





C 46,230,218





F 108,213,82



11111111111111111111111111111111
100000100000000100000000000000011
1000N00000000000000000010000000011
1000000000000000000000100000000001
11111111111111100000001000000000001
10000000000000000010000000000001111
100000000100000000000000000000001
100000000010000000010000100000001
10000000000000000000000000000001
11111111111111111111111111111111