EA ./path_to_the_east_texture
NO ./path_to_the_north_texture
SO ./path_to_the_south_texture
WE ./path_to_the_west_texture





C 92,0,1





F 22,0100,0



11111111111111111111111111111111
10000010000000000000000000000001
100N00010000000000000000000000001
11111111111111100000000000000000000000011
10000000000000000000000000000001111111111
10000000000000000000000000000001
10000000000000000000000000000001
10000000000000000000000000000001
10000000000000000000000000000001
11111111111111111111111111111111