EA ./path_to_the_east_texture
NO ./path_to_the_north_texture
SO ./path_to_the_south_texture
WE ./path_to_the_west_texture

C 225,30,0
F 220,100,0



        11111111111111111111111111111111
        10000010000000000000000000000001
        1000N010000000000000000000000001
11111111111111100000000000000000000000011
10000000000000000000000000000001111111111
10000000000000000000000000000001
10000000000000000000000000000001
10000000000000000000000000000001
10000000000000000000000000000001
11111111111111111111111111111111

