EA ./textures/East_wall.png
NO ./textures/North_wall.png
SO ./textures/South_wall.png
WE ./textures/West_wall.png





C 46,230,218





F 108,213,82



11111111111111111111111111111111
10000010000000000000000000000001
100N00010000000000000000000000001
11111111111111100000000000000000000000011
10000000000000000000000000000001111111111
10000000000000000000000000000001
10000000000000000000000000000001
10000000000000000000000000000001
10000000000000000000000000000001
11111111111111111111111111111111